F 15,6,0
C 15,6,0
EA ./textures/tex/glass01.xpm
NO ./textures/tex/glass01.xpm
SO ./textures/tex/glass01.xpm
WE ./textures/tex/glass01.xpm

111111111111111
1E0000000000001
100000000000001
100000000000001
100000100010001
100000000000001
100000000000001
100000000010001
100000000010001
111111111111111